8 8 1.5 1.5 0
#########
#_______#
#__####_#
#__#__#_#
#__#____#
####_####
#_______#
#########
